var world_01 = {
  array: [
      [1,1,1,1,1,1,1,1,1,1,1,1],
      [1,0,0,0,0,0,0,0,0,0,0,1],
      [1,0,0,0,0,0,1,1,0,1,0,1],
      [1,0,0,0,0,1,0,1,0,0,0,1],
      [1,0,0,1,0,0,0,0,0,0,0,1],
      [1,0,0,0,1,0,0,1,0,1,0,1],
      [1,0,0,0,1,0,1,1,0,0,0,1],
      [1,0,0,0,0,0,0,0,0,0,0,1],
      [1,0,1,0,0,0,0,0,0,1,0,1],
      [1,0,0,0,0,0,0,0,0,0,0,1],
      [1,1,1,1,1,1,1,1,1,1,1,1]
    ],
  initial_position: [225, 225],
  initial_normal: [0, -1]
};

orange = new Item("orange");
orange.setPosition(325, 325);
orange.setCollectible(false);
orange.setDimensions(200, 200);
orange.setup();